R 1366 768
NO ./src/wall2.xpm
SO ./src/pared1.xpm
WE ./src/pared2.xpm
EA ./src/pared3.xpm

S ./src/cow.xpm
F 33,33,33
C 242,243,244

11111111111111111111111111111
10000000001100000000000000001
10110000011100000020000010001
10010000000000000000000010001
10110000011100000000000010001
10000000001100000111011110001
11110111111111011100000010001
11110111111111011101010010001
11000000110101011100000010001
100020000000010001100000010001
10000000000000001101010010001
11000000110101011111011110N01
11110111111101011111011110001
11111111111111111111111111111
