R 1920 1080
NO ./src/wall2.xpm
SO ./src/pared1.xpm
WE ./src/pared2.xpm
EA ./src/pared3.xpm

S ./src/cow.xpm
F 33,33,33
C 242,243,244

111111111 22
10020000111111
1000N0001111 111
11111111111111